R 1024 768

NO /Users/gmayweat/Desktop/cub3d/textures/van.xpm

SO /Users/gmayweat/Desktop/cub3d/textures/WALL2.xpm

WE /Users/gmayweat/Desktop/cub3d/textures/WALL10.xpm

EA /Users/gmayweat/Desktop/cub3d/textures/WALL14.xpm

S /Users/gmayweat/Desktop/cub3d/textures/sprite.xpm

F 255,255,255

C 225,32,2

        1111111111111111111111111
        1222222222112222222222221
        1211222221112222221222221
        1221222222222222222222221
111111111211222221112222222222221
122222222211222221112111111111111
11112111111111211122222212221
11112111111111211121212212221
11222222112121211122222212221
1222222222N222221122222212221
12222222222222221121212212221
1122222111212121111121111222111
11112111 1112121 121111212221 
11111111 1111111 111111111111