R 1024 768

NO /Users/gmayweat/Desktop/cub3d/textures/van.xpm

SO /Users/gmayweat/Desktop/cub3d/textures/WALL2.xpm

WE /Users/gmayweat/Desktop/cub3d/textures/WALL10.xpm

EA /Users/gmayweat/Desktop/cub3d/textures/WALL14.xpm

S /Users/gmayweat/Desktop/cub3d/textures/sprite.xpm

F 255,255,255

C 225,30,0

        1111111111111111111111111
        1000000000110000000000001
        1011000001110000001000001
        1001000000000000000000001
111111111011000001110000000000001
100000000011000001110111111111111
11110111111111011100000010001
11110111111111011101010010001
11002000112101011100000010001
1002222000N000001100000010001
10000200000000001101010010001
1100000111010101111101111000111
11110111 1110101 101111010001 
11111111 1111111 111111111111