

NO /Users/gmayweat/Desktop/cub3d/textures/van.xpm
R 1024 768


WE /Users/gmayweat/Desktop/cub3d/textures/WALL10.xpm

EA /Users/gmayweat/Desktop/cub3d/textures/WALL68.xpm

S /Users/gmayweat/Desktop/cub3d/textures/sprite.xpm

F 255,255,0

C 225,30,0
SO /Users/gmayweat/Desktop/cub3d/textures/WALL2.xpm

        1111111111111111111111111
  1111  1000000000110000000000001
  1111  10110000011100000010000011
  1111  1001000000000000000000001
1111111110110000011100000000000011
100000000011000001110111111111111
11110111111111011100000010001
11110111111111011101010010001
11002000112101011100000010201
1002222000N000001100000010201
10000200000000001101010010201
1100000111010101111101111020111
11110111 1110101 101111010001 
11111111 1111111 111111111111